111111111111111111111111
1E000G000000000C00000CG1
10100101G010000010100101
10100100101010100G100101
1P0000000C00C000000000C1
111111111111111111111111